14
5 5 5 6 5 5 6 5 5 5 5 5 5 5 
5 3 5 5 2 5 5 5 2 1 5 6 6 5 
5 0 1 5 5 6 5 6 5 6 5 6 5 5 
5 5 5 5 5 6 5 5 5 5 5 5 5 0 
5 6 6 5 5 5 5 5 5 5 5 5 6 5 
5 6 5 5 5 5 5 5 5 5 0 2 5 5 
5 5 1 5 5 5 5 5 5 5 5 5 5 6 
6 5 5 5 5 5 5 5 5 5 5 3 5 5 
5 5 6 6 5 5 5 5 5 5 5 5 3 5 
5 2 5 5 5 5 5 5 5 5 5 6 1 5 
6 5 5 5 5 5 5 5 1 5 5 5 5 5 
5 5 6 5 2 5 3 5 6 5 5 6 6 5 
5 0 0 5 0 1 5 5 5 6 5 5 2 5 
5 5 5 5 5 5 5 6 5 5 1 5 5 5 
