14
6 0 5 1 5 5 5 5 5 5 5 5 5 6 
5 5 5 5 5 0 5 5 5 5 5 5 5 6 
5 5 1 5 5 5 5 5 5 6 5 3 5 5 
5 5 5 5 1 5 5 5 6 5 5 5 5 6 
5 5 0 5 6 5 5 5 1 1 0 5 5 5 
5 5 5 6 0 6 5 5 6 5 5 5 0 5 
5 5 5 5 5 5 6 0 5 5 5 5 5 5 
5 5 5 5 5 5 6 6 5 5 5 5 5 5 
5 2 5 5 5 2 5 5 0 0 6 5 5 5 
5 5 5 2 0 6 5 5 5 1 5 6 5 5 
6 5 5 5 5 6 5 5 5 6 5 5 5 5 
5 5 6 5 2 5 5 5 5 5 5 0 5 5 
6 5 5 5 5 5 5 5 1 5 5 5 5 5 
6 5 5 5 5 5 5 5 5 5 6 5 2 6 
