7
5 5 5 5 5 6 5 
6 5 1 5 5 5 5 
5 5 5 6 5 3 5 
5 5 2 5 6 5 5 
5 0 6 2 5 5 5 
5 5 5 5 6 5 2 
1 0 5 5 5 5 5 
