7
5 5 5 5 5 2 5 
1 5 0 5 5 5 5 
5 5 5 2 5 6 5 
5 5 2 5 3 5 5 
5 6 5 2 5 5 5 
5 5 5 5 1 5 6 
5 6 5 5 5 5 5 
