10
5 5 5 5 3 5 5 5 5 5 
5 5 5 2 5 3 5 5 5 5 
5 5 5 5 5 5 5 5 5 5 
5 5 5 5 6 5 5 5 2 5 
5 3 5 5 6 6 2 5 5 6 
3 5 5 2 6 6 5 5 3 5 
5 3 5 5 5 6 5 5 5 5 
5 5 5 5 5 5 5 5 5 5 
5 5 5 5 6 5 3 5 5 5 
5 5 5 5 5 3 5 5 5 5 
